HB,Month,FirstContactAppointments,FirstContactAppointmentsQF,DidNotAttends,DidNotAttendsQF,TotalAppointments,TotalAppointmentsQF
S08000015,202503,97,,11,,108,
S08000016,202503,12,,7,,19,
S08000017,202503,188,,1,,189,
S08000019,202503,73,,8,,81,
S08000020,202503,201,,17,,218,
S08000022,202503,63,,4,,67,
S08000024,202503,315,,33,,348,
S08000025,202503,11,,1,,12,
S08000026,202503,16,,2,,18,
S08000028,202503,10,,0,,10,
S08000029,202503,129,,7,,136,
S08000030,202503,96,,7,,103,
S08000031,202503,326,,34,,360,
S08000032,202503,163,,44,,207,
S92000003,202503,1700,d,176,d,1876,d
S08000015,202502,82,,9,,91,
S08000016,202502,15,,4,,19,
S08000017,202502,160,,2,,162,
S08000019,202502,83,,9,,92,
S08000020,202502,177,,8,,185,
S08000022,202502,101,,15,,116,
S08000024,202502,337,,28,,365,
S08000025,202502,6,,0,,6,
S08000026,202502,6,,3,,9,
S08000028,202502,13,,2,,15,
S08000029,202502,100,,9,,109,
S08000030,202502,94,,6,,100,
S08000031,202502,317,,34,,351,
S08000032,202502,205,,52,,257,
S92000003,202502,1696,d,181,d,1877,d
S08000015,202501,88,,7,,95,
S08000016,202501,13,,1,,14,
S08000017,202501,137,,2,,139,
S08000019,202501,77,,11,,88,
S08000020,202501,188,,20,,208,
S08000022,202501,77,,5,,82,
S08000024,202501,334,,33,,367,
S08000025,202501,7,,3,,10,
S08000026,202501,9,,1,,10,
S08000028,202501,13,,2,,15,
S08000029,202501,111,,12,,123,
S08000030,202501,77,,11,,88,
S08000031,202501,333,,33,,366,
S08000032,202501,138,,20,,158,
S92000003,202501,1602,d,161,d,1763,d
S08000015,202412,70,,10,,80,
S08000016,202412,18,,2,,20,
S08000017,202412,107,,2,,109,
S08000019,202412,54,,5,,59,
S08000020,202412,186,,8,,194,
S08000022,202412,72,,7,,79,
S08000024,202412,324,,29,,353,
S08000025,202412,5,,2,,7,
S08000026,202412,5,,1,,6,
S08000028,202412,12,,0,,12,
S08000029,202412,78,,9,,87,
S08000030,202412,88,,13,,101,
S08000031,202412,230,,26,,256,
S08000032,202412,96,,22,,118,
S92000003,202412,1345,d,136,d,1481,d
S08000015,202411,96,,6,,102,
S08000016,202411,25,,4,,29,
S08000017,202411,116,,2,,118,
S08000019,202411,90,,6,,96,
S08000020,202411,199,,17,,216,
S08000022,202411,118,,7,,125,
S08000024,202411,386,,29,,415,
S08000025,202411,9,,1,,10,
S08000026,202411,10,,2,,12,
S08000028,202411,22,,1,,23,
S08000029,202411,141,,9,,150,
S08000030,202411,72,,10,,82,
S08000031,202411,338,,25,,363,
S08000032,202411,170,,40,,210,
S92000003,202411,1792,d,159,d,1951,d
S08000015,202410,101,,6,,107,
S08000016,202410,21,,2,,23,
S08000017,202410,136,,3,,139,
S08000019,202410,99,,6,,105,
S08000020,202410,170,,19,,189,
S08000022,202410,90,,15,,105,
S08000024,202410,399,,43,,442,
S08000025,202410,10,,5,,15,
S08000026,202410,9,,0,,9,
S08000028,202410,10,,1,,11,
S08000029,202410,131,,12,,143,
S08000030,202410,83,,9,,92,
S08000031,202410,289,,25,,314,
S08000032,202410,197,,31,,228,
S92000003,202410,1745,d,177,d,1922,d
S08000015,202409,80,,9,,89,
S08000016,202409,16,,0,,16,
S08000017,202409,120,,4,,124,
S08000019,202409,76,,6,,82,
S08000020,202409,165,,15,,180,
S08000022,202409,103,,8,,111,
S08000024,202409,346,,35,,381,
S08000025,202409,8,,1,,9,
S08000026,202409,14,,1,,15,
S08000028,202409,15,,1,,16,
S08000029,202409,157,,17,,174,
S08000030,202409,95,,6,,101,
S08000031,202409,298,,24,,322,
S08000032,202409,102,,17,,119,
S92000003,202409,1595,d,144,d,1739,d
S08000015,202408,70,,7,,77,
S08000016,202408,8,,1,,9,
S08000017,202408,95,,4,,99,
S08000019,202408,100,,3,,103,
S08000020,202408,171,,27,,198,
S08000022,202408,89,,14,,103,
S08000024,202408,343,,45,,388,
S08000025,202408,9,,1,,10,
S08000026,202408,6,,4,,10,
S08000028,202408,7,,0,,7,
S08000029,202408,115,,10,,125,
S08000030,202408,87,,11,,98,
S08000031,202408,255,,34,,289,
S08000032,202408,106,,21,,127,
S92000003,202408,1461,d,182,d,1643,d
S08000015,202407,78,,8,,86,
S08000016,202407,22,,1,,23,
S08000017,202407,83,,5,,88,
S08000019,202407,84,,2,,86,
S08000020,202407,147,,14,,161,
S08000022,202407,90,,15,,105,
S08000024,202407,323,,60,,383,
S08000025,202407,10,,1,,11,
S08000026,202407,7,,2,,9,
S08000028,202407,7,,0,,7,
S08000029,202407,114,,9,,123,
S08000030,202407,91,,17,,108,
S08000031,202407,271,,42,,313,
S08000032,202407,268,,80,,348,
S92000003,202407,1595,d,256,d,1851,d
S08000015,202406,87,,6,,93,
S08000016,202406,4,,2,,6,
S08000017,202406,103,,5,,108,
S08000019,202406,93,,10,,103,
S08000020,202406,163,,11,,174,
S08000022,202406,94,,8,,102,
S08000024,202406,342,,42,,384,
S08000025,202406,12,,5,,17,
S08000026,202406,6,,1,,7,
S08000028,202406,19,,3,,22,
S08000029,202406,155,,11,,166,
S08000030,202406,88,,16,,104,
S08000031,202406,305,,30,,335,
S08000032,202406,116,,31,,147,
S92000003,202406,1587,d,181,d,1768,d
S08000015,202405,109,,13,,122,
S08000016,202405,18,,0,,18,
S08000017,202405,108,,2,,110,
S08000019,202405,123,,15,,138,
S08000020,202405,189,,13,,202,
S08000022,202405,119,,5,,124,
S08000024,202405,437,,58,,495,
S08000025,202405,10,,0,,10,
S08000026,202405,3,,0,,3,
S08000028,202405,19,,3,,22,
S08000029,202405,159,,12,,171,
S08000030,202405,109,,18,,127,
S08000031,202405,401,,23,,424,
S08000032,202405,126,,25,,151,
S92000003,202405,1930,d,187,d,2117,d
S08000015,202404,106,,13,,119,
S08000016,202404,18,,2,,20,
S08000017,202404,117,,2,,119,
S08000019,202404,111,,6,,117,
S08000020,202404,309,,22,,331,
S08000022,202404,89,,12,,101,
S08000024,202404,346,,53,,399,
S08000025,202404,5,,1,,6,
S08000026,202404,11,,1,,12,
S08000028,202404,11,,0,,11,
S08000029,202404,154,,9,,163,
S08000030,202404,80,,8,,88,
S08000031,202404,312,,33,,345,
S08000032,202404,288,,76,,364,
S92000003,202404,1957,d,238,d,2195,d
S08000015,202403,101,,7,,108,
S08000016,202403,28,,2,,30,
S08000017,202403,95,,6,,101,
S08000019,202403,124,,8,,132,
S08000020,202403,168,,11,,179,
S08000022,202403,83,,8,,91,
S08000024,202403,424,,44,,468,
S08000025,202403,12,,2,,14,
S08000026,202403,9,,1,,10,
S08000028,202403,18,,0,,18,
S08000029,202403,127,,6,,133,
S08000030,202403,84,,11,,95,
S08000031,202403,359,,40,,399,
S08000032,202403,118,,26,,144,
S92000003,202403,1750,d,172,d,1922,d
S08000015,202402,132,,12,,144,
S08000016,202402,29,,3,,32,
S08000017,202402,153,,1,,154,
S08000019,202402,148,,13,,161,
S08000020,202402,167,,11,,178,
S08000022,202402,96,,0,,96,
S08000024,202402,419,,63,,482,
S08000025,202402,6,,2,,8,
S08000026,202402,7,,0,,7,
S08000028,202402,10,,2,,12,
S08000029,202402,151,,12,,163,
S08000030,202402,101,,10,,111,
S08000031,202402,364,,29,,393,
S08000032,202402,137,,18,,155,
S92000003,202402,1920,d,176,d,2096,d
S08000015,202401,140,,15,,155,
S08000016,202401,28,,3,,31,
S08000017,202401,95,,6,,101,
S08000019,202401,106,,5,,111,
S08000020,202401,158,,10,,168,
S08000022,202401,74,,12,,86,
S08000024,202401,490,,74,,564,
S08000025,202401,7,,0,,7,
S08000026,202401,7,,1,,8,
S08000028,202401,5,,0,,5,
S08000029,202401,163,,10,,173,
S08000030,202401,128,,12,,140,
S08000031,202401,304,,32,,336,
S08000032,202401,122,,20,,142,
S92000003,202401,1827,d,200,d,2027,d
S08000015,202312,125,,30,,155,
S08000016,202312,11,,1,,12,
S08000017,202312,87,,10,,97,
S08000019,202312,62,,4,,66,
S08000020,202312,148,,10,,158,
S08000022,202312,68,,6,,74,
S08000024,202312,337,,50,,387,
S08000025,202312,6,,0,,6,
S08000026,202312,3,,0,,3,
S08000028,202312,9,,0,,9,
S08000029,202312,110,,7,,117,
S08000030,202312,133,,14,,147,
S08000031,202312,288,,26,,314,
S08000032,202312,97,,23,,120,
S92000003,202312,1484,d,181,d,1665,d
S08000015,202311,186,,36,,222,
S08000016,202311,30,,2,,32,
S08000017,202311,124,,8,,132,
S08000019,202311,110,,10,,120,
S08000020,202311,206,,17,,223,
S08000022,202311,90,,10,,100,
S08000024,202311,494,,64,,558,
S08000025,202311,4,,2,,6,
S08000026,202311,8,,0,,8,
S08000028,202311,14,,0,,14,
S08000029,202311,183,,9,,192,
S08000030,202311,162,,17,,179,
S08000031,202311,384,,48,,432,
S08000032,202311,142,,24,,166,
S92000003,202311,2137,d,247,d,2384,d
S08000015,202310,232,,33,,265,
S08000016,202310,40,,0,,40,
S08000017,202310,83,,5,,88,
S08000019,202310,83,,5,,88,
S08000020,202310,177,,8,,185,
S08000022,202310,77,,5,,82,
S08000024,202310,517,,68,,585,
S08000025,202310,13,,2,,15,
S08000026,202310,6,,1,,7,
S08000028,202310,10,,2,,12,
S08000029,202310,142,,13,,155,
S08000030,202310,141,,25,,166,
S08000031,202310,416,,55,,471,
S08000032,202310,150,,34,,184,
S92000003,202310,2087,d,256,d,2343,d
S08000015,202309,241,,31,,272,
S08000016,202309,27,,1,,28,
S08000017,202309,91,,10,,101,
S08000019,202309,40,,3,,43,
S08000020,202309,134,,8,,142,
S08000022,202309,75,,4,,79,
S08000024,202309,469,,33,,502,
S08000025,202309,15,,6,,21,
S08000026,202309,5,,3,,8,
S08000028,202309,9,,1,,10,
S08000029,202309,142,,15,,157,
S08000030,202309,116,,11,,127,
S08000031,202309,439,,64,,503,
S08000032,202309,114,,36,,150,
S92000003,202309,1917,d,226,d,2143,d
S08000015,202308,206,,36,,242,
S08000016,202308,39,,3,,42,
S08000017,202308,50,,5,,55,
S08000019,202308,79,,14,,93,
S08000020,202308,173,,13,,186,
S08000022,202308,63,,7,,70,
S08000024,202308,463,,55,,518,
S08000025,202308,13,,2,,15,
S08000026,202308,11,,1,,12,
S08000028,202308,6,,0,,6,
S08000029,202308,130,,10,,140,
S08000030,202308,121,,17,,138,
S08000031,202308,506,,74,,580,
S08000032,202308,242,,106,,348,
S92000003,202308,2102,d,343,d,2445,d
S08000015,202307,198,,37,,235,
S08000016,202307,31,,4,,35,
S08000017,202307,69,,9,,78,
S08000019,202307,79,,10,,89,
S08000020,202307,131,,8,,139,
S08000022,202307,56,,15,,71,
S08000024,202307,418,,50,,468,
S08000025,202307,17,,2,,19,
S08000026,202307,6,,4,,10,
S08000028,202307,4,,0,,4,
S08000029,202307,93,,12,,105,
S08000030,202307,74,,14,,88,
S08000031,202307,416,,82,,498,
S08000032,202307,215,,103,,318,
S92000003,202307,1807,d,350,d,2157,d
S08000015,202306,227,,28,,255,
S08000016,202306,34,,2,,36,
S08000017,202306,143,,5,,148,
S08000019,202306,62,,16,,78,
S08000020,202306,128,,7,,135,
S08000022,202306,98,,9,,107,
S08000024,202306,497,,59,,556,
S08000025,202306,12,,2,,14,
S08000026,202306,16,,0,,16,
S08000028,202306,14,,0,,14,
S08000029,202306,136,,17,,153,
S08000030,202306,129,,16,,145,
S08000031,202306,497,,85,,582,
S08000032,202306,233,,95,,328,
S92000003,202306,2226,d,341,d,2567,d
S08000015,202305,192,,45,,237,
S08000016,202305,38,,4,,42,
S08000017,202305,143,,4,,147,
S08000019,202305,122,,8,,130,
S08000020,202305,178,,11,,189,
S08000022,202305,94,,9,,103,
S08000024,202305,465,,43,,508,
S08000025,202305,17,,0,,17,
S08000026,202305,7,,1,,8,
S08000028,202305,10,,2,,12,
S08000029,202305,141,,20,,161,
S08000030,202305,150,,17,,167,
S08000031,202305,549,,72,,621,
S08000032,202305,255,,78,,333,
S92000003,202305,2361,d,314,d,2675,d
S08000015,202304,149,,20,,169,
S08000016,202304,29,,3,,32,
S08000017,202304,54,,4,,58,
S08000019,202304,95,,7,,102,
S08000020,202304,127,,5,,132,
S08000022,202304,84,,6,,90,
S08000024,202304,379,,34,,413,
S08000025,202304,12,,0,,12,
S08000026,202304,7,,3,,10,
S08000028,202304,15,,2,,17,
S08000029,202304,121,,22,,143,
S08000030,202304,104,,9,,113,
S08000031,202304,456,,76,,532,
S08000032,202304,206,,68,,274,
S92000003,202304,1838,d,259,d,2097,d
S08000015,202303,247,,35,,282,
S08000016,202303,34,,3,,37,
S08000017,202303,58,,2,,60,
S08000019,202303,87,,8,,95,
S08000020,202303,153,,13,,166,
S08000022,202303,99,,14,,113,
S08000024,202303,439,,48,,487,
S08000025,202303,8,,0,,8,
S08000026,202303,10,,1,,11,
S08000028,202303,11,,0,,11,
S08000029,202303,128,,14,,142,
S08000030,202303,120,,10,,130,
S08000031,202303,501,,67,,568,
S08000032,202303,231,,48,,279,
S92000003,202303,2126,d,263,d,2389,d
S08000015,202302,207,,36,,243,
S08000016,202302,46,,3,,49,
S08000017,202302,82,,1,,83,
S08000019,202302,83,,7,,90,
S08000020,202302,151,,8,,159,
S08000022,202302,124,,5,,129,
S08000024,202302,380,,37,,417,
S08000025,202302,7,,0,,7,
S08000026,202302,10,,3,,13,
S08000028,202302,15,,0,,15,
S08000029,202302,179,,27,,206,
S08000030,202302,120,,13,,133,
S08000031,202302,452,,50,,502,
S08000032,202302,215,,60,,275,
S92000003,202302,2071,d,250,d,2321,d
S08000015,202301,150,,32,,182,
S08000016,202301,49,,2,,51,
S08000017,202301,77,,6,,83,
S08000019,202301,116,,4,,120,
S08000020,202301,131,,17,,148,
S08000022,202301,165,,11,,176,
S08000024,202301,341,,37,,378,
S08000025,202301,7,,0,,7,
S08000026,202301,14,,10,,24,
S08000028,202301,11,,0,,11,
S08000029,202301,152,,26,,178,
S08000030,202301,120,,13,,133,
S08000031,202301,420,,51,,471,
S08000032,202301,165,,94,,259,
S92000003,202301,1918,d,303,d,2221,d
S08000015,202212,208,,43,,251,
S08000016,202212,41,,3,,44,
S08000017,202212,76,,3,,79,
S08000019,202212,93,,4,,97,
S08000020,202212,131,,8,,139,
S08000022,202212,106,,22,,128,
S08000024,202212,494,,38,,532,
S08000025,202212,15,,0,,15,
S08000026,202212,7,,0,,7,
S08000028,202212,13,,0,,13,
S08000029,202212,165,,22,,187,
S08000030,202212,99,,15,,114,
S08000031,202212,408,,75,,483,
S08000032,202212,197,,68,,265,
S92000003,202212,2053,d,301,d,2354,d
S08000015,202211,317,,55,,372,
S08000016,202211,66,,2,,68,
S08000017,202211,115,,9,,124,
S08000019,202211,123,,13,,136,
S08000020,202211,172,,9,,181,
S08000022,202211,179,,19,,198,
S08000024,202211,494,,38,,532,
S08000025,202211,27,,0,,27,
S08000026,202211,11,,0,,11,
S08000028,202211,20,,1,,21,
S08000029,202211,196,,30,,226,
S08000030,202211,146,,10,,156,
S08000031,202211,622,,81,,703,
S08000032,202211,314,,81,,395,
S92000003,202211,2802,d,348,d,3150,d
S08000015,202210,138,,15,,153,
S08000016,202210,51,,0,,51,
S08000017,202210,88,,13,,101,
S08000019,202210,89,,5,,94,
S08000020,202210,156,,12,,168,
S08000022,202210,106,,13,,119,
S08000024,202210,452,,48,,500,
S08000025,202210,13,,0,,13,
S08000026,202210,6,,0,,6,
S08000028,202210,15,,2,,17,
S08000029,202210,169,,39,,208,
S08000030,202210,136,,15,,151,
S08000031,202210,583,,70,,653,
S08000032,202210,262,,72,,334,
S92000003,202210,2264,d,304,d,2568,d
S08000015,202209,112,,10,,122,
S08000016,202209,49,,1,,50,
S08000017,202209,77,,3,,80,
S08000019,202209,105,,10,,115,
S08000020,202209,,:,,:,,:
S08000022,202209,126,,7,,133,
S08000024,202209,430,,46,,476,
S08000025,202209,5,,0,,5,
S08000026,202209,10,,1,,11,
S08000028,202209,10,,1,,11,
S08000029,202209,187,,32,,219,
S08000030,202209,134,,13,,147,
S08000031,202209,535,,76,,611,
S08000032,202209,250,,36,,286,
S92000003,202209,2030,d y,236,d y,2266,d y
S08000015,202208,114,,31,,145,
S08000016,202208,53,,3,,56,
S08000017,202208,95,,9,,104,
S08000019,202208,109,,13,,122,
S08000020,202208,,:,,:,,:
S08000022,202208,135,,15,,150,
S08000024,202208,518,,50,,568,
S08000025,202208,14,,0,,14,
S08000026,202208,10,,5,,15,
S08000028,202208,15,,0,,15,
S08000029,202208,134,,34,,168,
S08000030,202208,108,,8,,116,
S08000031,202208,545,,86,,631,
S08000032,202208,214,,37,,251,
S92000003,202208,2064,d y,291,d y,2355,d y
S08000015,202207,81,,21,,102,
S08000016,202207,43,,4,,47,
S08000017,202207,89,,10,,99,
S08000019,202207,48,,2,,50,
S08000020,202207,,:,,:,,:
S08000022,202207,73,,7,,80,
S08000024,202207,351,,45,,396,
S08000025,202207,15,,0,,15,
S08000026,202207,6,,0,,6,
S08000028,202207,8,,1,,9,
S08000029,202207,144,,28,,172,
S08000030,202207,82,,10,,92,
S08000031,202207,493,,93,,586,
S08000032,202207,81,,16,,97,
S92000003,202207,1514,d y,237,d y,1751,d y
S08000015,202206,106,,15,,121,
S08000016,202206,47,,1,,48,
S08000017,202206,100,,5,,105,
S08000019,202206,71,,7,,78,
S08000020,202206,,:,,:,,:
S08000022,202206,111,,5,,116,
S08000024,202206,386,,45,,431,
S08000025,202206,9,,0,,9,
S08000026,202206,12,,1,,13,
S08000028,202206,12,,1,,13,
S08000029,202206,187,,33,,220,
S08000030,202206,103,,10,,113,
S08000031,202206,585,,95,,680,
S08000032,202206,90,,11,,101,
S92000003,202206,1819,d y,229,d y,2048,d y
S08000015,202205,141,,23,,164,
S08000016,202205,34,,1,,35,
S08000017,202205,130,,13,,143,
S08000019,202205,52,,4,,56,
S08000020,202205,,:,,:,,:
S08000022,202205,41,,2,,43,
S08000024,202205,395,,43,,438,
S08000025,202205,9,,0,,9,
S08000026,202205,11,,1,,12,
S08000028,202205,20,,0,,20,
S08000029,202205,218,,36,,254,
S08000030,202205,117,,16,,133,
S08000031,202205,643,,108,,751,
S08000032,202205,105,,8,,113,
S92000003,202205,1916,d y,255,d y,2171,d y
S08000015,202204,129,,16,,145,
S08000016,202204,26,,0,,26,
S08000017,202204,62,,12,,74,
S08000019,202204,50,,4,,54,
S08000020,202204,,:,,:,,:
S08000022,202204,88,,5,,93,
S08000024,202204,296,,48,,344,
S08000025,202204,8,,0,,8,
S08000026,202204,3,,5,,8,
S08000028,202204,16,,2,,18,
S08000029,202204,151,,30,,181,
S08000030,202204,126,,27,,153,
S08000031,202204,573,,105,,678,
S08000032,202204,76,,6,,82,
S92000003,202204,1604,d y,260,d y,1864,d y
S08000015,202203,177,,20,,197,
S08000016,202203,34,,0,,34,
S08000017,202203,110,,10,,120,
S08000019,202203,79,,5,,84,
S08000020,202203,,:,,:,,:
S08000022,202203,117,,5,,122,
S08000024,202203,354,,39,,393,
S08000025,202203,17,,0,,17,
S08000026,202203,8,,3,,11,
S08000028,202203,11,,0,,11,
S08000029,202203,235,,35,,270,
S08000030,202203,130,,17,,147,
S08000031,202203,596,,82,,678,
S08000032,202203,111,,6,,117,
S92000003,202203,1979,d y,222,d y,2201,d y
S08000015,202202,151,,28,,179,
S08000016,202202,24,,4,,28,
S08000017,202202,77,,7,,84,
S08000019,202202,101,,8,,109,
S08000020,202202,,:,,:,,:
S08000022,202202,97,,6,,103,
S08000024,202202,302,,38,,340,
S08000025,202202,9,,0,,9,
S08000026,202202,8,,2,,10,
S08000028,202202,8,,0,,8,
S08000029,202202,194,,24,,218,
S08000030,202202,105,,18,,123,
S08000031,202202,487,,66,,553,
S08000032,202202,67,,9,,76,
S92000003,202202,1630,d y,210,d y,1840,d y
S08000015,202201,112,,38,,150,
S08000016,202201,29,,4,,33,
S08000017,202201,95,,3,,98,
S08000019,202201,27,,3,,30,
S08000020,202201,,:,,:,,:
S08000022,202201,72,,2,,74,
S08000024,202201,304,,39,,343,
S08000025,202201,11,,0,,11,
S08000026,202201,5,,4,,9,
S08000028,202201,7,,0,,7,
S08000029,202201,188,,30,,218,
S08000030,202201,136,,17,,153,
S08000031,202201,432,,72,,504,
S08000032,202201,63,,5,,68,
S92000003,202201,1481,d y,217,d y,1698,d y
S08000015,202112,95,,12,,107,
S08000016,202112,19,,3,,22,
S08000017,202112,89,,3,,92,
S08000019,202112,30,,5,,35,
S08000020,202112,,:,,:,,:
S08000022,202112,91,,3,,94,
S08000024,202112,319,,30,,349,
S08000025,202112,,:,,:,,:
S08000026,202112,8,,2,,10,
S08000028,202112,15,,0,,15,
S08000029,202112,142,,30,,172,
S08000030,202112,136,,14,,150,
S08000031,202112,458,,97,,555,
S08000032,202112,96,,13,,109,
S92000003,202112,1498,d y,212,d y,1710,d y
S08000015,202111,139,,22,,161,
S08000016,202111,34,,1,,35,
S08000017,202111,140,,3,,143,
S08000019,202111,37,,8,,45,
S08000020,202111,,:,,:,,:
S08000022,202111,144,,4,,148,
S08000024,202111,405,,48,,453,
S08000025,202111,,:,,:,,:
S08000026,202111,11,,0,,11,
S08000028,202111,18,,0,,18,
S08000029,202111,207,,45,,252,
S08000030,202111,151,,14,,165,
S08000031,202111,572,,74,,646,
S08000032,202111,153,,10,,163,
S92000003,202111,2011,d y,229,d y,2240,d y
S08000015,202110,106,,18,,124,
S08000016,202110,16,,2,,18,
S08000017,202110,69,,2,,71,
S08000019,202110,54,,5,,59,
S08000020,202110,,:,,:,,:
S08000022,202110,67,,9,,76,
S08000024,202110,326,,34,,360,
S08000025,202110,,:,,:,,:
S08000026,202110,3,,1,,4,
S08000028,202110,7,,1,,8,
S08000029,202110,149,,30,,179,
S08000030,202110,123,,12,,135,
S08000031,202110,534,,77,,611,
S08000032,202110,103,,2,,105,
S92000003,202110,1557,d y,193,d y,1750,d y
S08000015,202109,141,,21,,162,
S08000016,202109,16,,5,,21,
S08000017,202109,67,,1,,68,
S08000019,202109,37,,5,,42,
S08000020,202109,,:,,:,,:
S08000022,202109,71,,4,,75,
S08000024,202109,362,,38,,400,
S08000025,202109,,:,,:,,:
S08000026,202109,9,,2,,11,
S08000028,202109,15,,2,,17,
S08000029,202109,198,,35,,233,
S08000030,202109,186,,30,,216,
S08000031,202109,374,,53,,427,
S08000032,202109,94,,7,,101,
S92000003,202109,1570,d y,203,d y,1773,d y
S08000015,202108,108,,32,,140,
S08000016,202108,37,,3,,40,
S08000017,202108,62,,0,,62,
S08000019,202108,28,,3,,31,
S08000020,202108,,:,,:,,:
S08000022,202108,79,,3,,82,
S08000024,202108,318,,52,,370,
S08000025,202108,,:,,:,,:
S08000026,202108,5,,1,,6,
S08000028,202108,9,,0,,9,
S08000029,202108,150,,44,,194,
S08000030,202108,155,,24,,179,
S08000031,202108,323,,91,,414,
S08000032,202108,80,,10,,90,
S92000003,202108,1354,d y,263,d y,1617,d y
S08000015,202107,115,,29,,144,
S08000016,202107,31,,8,,39,
S08000017,202107,49,,1,,50,
S08000019,202107,35,,4,,39,
S08000020,202107,,:,,:,,:
S08000022,202107,108,,12,,120,
S08000024,202107,328,,50,,378,
S08000025,202107,,:,,:,,:
S08000026,202107,5,,1,,6,
S08000028,202107,11,,0,,11,
S08000029,202107,158,,41,,199,
S08000030,202107,109,,21,,130,
S08000031,202107,302,,102,,404,
S08000032,202107,90,,19,,109,
S92000003,202107,1341,d y,288,d y,1629,d y
S08000015,202106,124,,28,,152,
S08000016,202106,39,,6,,45,
S08000017,202106,64,,2,,66,
S08000019,202106,40,,7,,47,
S08000020,202106,,:,,:,,:
S08000022,202106,128,,10,,138,
S08000024,202106,412,,56,,468,
S08000025,202106,,:,,:,,:
S08000026,202106,5,,0,,5,
S08000028,202106,21,,3,,24,
S08000029,202106,306,,59,,365,
S08000030,202106,161,,26,,187,
S08000031,202106,432,,110,,542,
S08000032,202106,107,,16,,123,
S92000003,202106,1839,d y,323,d y,2162,d y
S08000015,202105,111,,25,,136,
S08000016,202105,29,,5,,34,
S08000017,202105,59,,1,,60,
S08000019,202105,49,,4,,53,
S08000020,202105,,:,,:,,:
S08000022,202105,115,,8,,123,
S08000024,202105,446,,41,,487,
S08000025,202105,,:,,:,,:
S08000026,202105,11,,0,,11,
S08000028,202105,14,,5,,19,
S08000029,202105,275,,42,,317,
S08000030,202105,122,,17,,139,
S08000031,202105,422,,97,,519,
S08000032,202105,151,,23,,174,
S92000003,202105,1804,d y,268,d y,2072,d y
S08000015,202104,111,,12,,123,
S08000016,202104,36,,1,,37,
S08000017,202104,57,,4,,61,
S08000019,202104,63,,4,,67,
S08000020,202104,,:,,:,,:
S08000022,202104,89,,8,,97,
S08000024,202104,401,,48,,449,
S08000025,202104,,:,,:,,:
S08000026,202104,12,,3,,15,
S08000028,202104,15,,1,,16,
S08000029,202104,239,,62,,301,
S08000030,202104,138,,27,,165,
S08000031,202104,424,,93,,517,
S08000032,202104,161,,27,,188,
S92000003,202104,1746,d y,290,d y,2036,d y
S08000015,202103,123,,19,,142,
S08000016,202103,51,,1,,52,
S08000017,202103,65,,4,,69,
S08000019,202103,50,,6,,56,
S08000020,202103,,:,,:,,:
S08000022,202103,64,,8,,72,
S08000024,202103,336,,50,,386,
S08000025,202103,7,,5,,12,
S08000026,202103,13,,6,,19,
S08000028,202103,14,,0,,14,
S08000029,202103,323,,64,,387,
S08000030,202103,136,,17,,153,
S08000031,202103,513,,91,,604,
S08000032,202103,146,,19,,165,
S92000003,202103,1841,d y,290,d y,2131,d y
S08000015,202102,97,,18,,115,
S08000016,202102,39,,4,,43,
S08000017,202102,63,,2,,65,
S08000019,202102,42,,12,,54,
S08000020,202102,,:,,:,,:
S08000022,202102,91,,9,,100,
S08000024,202102,323,,34,,357,
S08000025,202102,5,,3,,8,
S08000026,202102,3,,2,,5,
S08000028,202102,14,,0,,14,
S08000029,202102,191,,54,,245,
S08000030,202102,121,,19,,140,
S08000031,202102,447,,132,,579,
S08000032,202102,114,,9,,123,
S92000003,202102,1550,d y,298,d y,1848,d y
S08000015,202101,86,,14,,100,
S08000016,202101,23,,8,,31,
S08000017,202101,58,,6,,64,
S08000019,202101,71,,14,,85,
S08000020,202101,,:,,:,,:
S08000022,202101,97,,8,,105,
S08000024,202101,290,,55,,345,
S08000025,202101,4,,1,,5,
S08000026,202101,5,,0,,5,
S08000028,202101,8,,1,,9,
S08000029,202101,185,,81,,266,
S08000030,202101,115,,29,,144,
S08000031,202101,470,,176,,646,
S08000032,202101,75,,14,,89,
S92000003,202101,1487,d y,407,d y,1894,d y
S08000015,202012,106,,18,,124,
S08000016,202012,17,,6,,23,
S08000017,202012,73,,9,,82,
S08000019,202012,34,,4,,38,
S08000020,202012,,:,,:,,:
S08000022,202012,87,,5,,92,
S08000024,202012,297,,34,,331,
S08000025,202012,6,,1,,7,
S08000026,202012,6,,0,,6,
S08000028,202012,11,,1,,12,
S08000029,202012,192,,50,,242,
S08000030,202012,102,,18,,120,
S08000031,202012,473,,147,,620,
S08000032,202012,92,,14,,106,
S92000003,202012,1496,d y,307,d y,1803,d y
S08000015,202011,130,,16,,146,
S08000016,202011,17,,0,,17,
S08000017,202011,64,,2,,66,
S08000019,202011,76,,8,,84,
S08000020,202011,,:,,:,,:
S08000022,202011,103,,9,,112,
S08000024,202011,347,,40,,387,
S08000025,202011,2,,1,,3,
S08000026,202011,6,,0,,6,
S08000028,202011,13,,0,,13,
S08000029,202011,269,,41,,310,
S08000030,202011,121,,17,,138,
S08000031,202011,494,,108,,602,
S08000032,202011,142,,7,,149,
S92000003,202011,1784,d y,249,d y,2033,d y
S08000015,202010,76,,13,,89,
S08000016,202010,20,,1,,21,
S08000017,202010,57,,6,,63,
S08000019,202010,99,,5,,104,
S08000020,202010,,:,,:,,:
S08000022,202010,120,,9,,129,
S08000024,202010,288,,37,,325,
S08000025,202010,3,,1,,4,
S08000026,202010,4,,0,,4,
S08000028,202010,18,,2,,20,
S08000029,202010,178,,29,,207,
S08000030,202010,135,,20,,155,
S08000031,202010,475,,113,,588,
S08000032,202010,111,,15,,126,
S92000003,202010,1584,d y,251,d y,1835,d y
S08000015,202009,76,,17,,93,
S08000016,202009,16,,1,,17,
S08000017,202009,83,,3,,86,
S08000019,202009,81,,1,,82,
S08000020,202009,,:,,:,,:
S08000022,202009,136,,14,,150,
S08000024,202009,291,,33,,324,
S08000025,202009,7,,1,,8,
S08000026,202009,7,,1,,8,
S08000028,202009,18,,2,,20,
S08000029,202009,179,,33,,212,
S08000030,202009,151,,13,,164,
S08000031,202009,474,,144,,618,
S08000032,202009,119,,11,,130,
S92000003,202009,1638,d y,274,d y,1912,d y
S08000015,202008,77,,18,,95,
S08000016,202008,12,,1,,13,
S08000017,202008,47,,3,,50,
S08000019,202008,70,,3,,73,
S08000020,202008,,:,,:,,:
S08000022,202008,66,,3,,69,
S08000024,202008,233,,17,,250,
S08000025,202008,0,,0,,0,
S08000026,202008,6,,0,,6,
S08000028,202008,7,,1,,8,
S08000029,202008,121,,37,,158,
S08000030,202008,155,,29,,184,
S08000031,202008,426,,112,,538,
S08000032,202008,114,,10,,124,
S92000003,202008,1334,d y,234,d y,1568,d y
S08000015,202007,84,,7,,91,
S08000016,202007,13,,2,,15,
S08000017,202007,42,,4,,46,
S08000019,202007,89,,0,,89,
S08000020,202007,,:,,:,,:
S08000022,202007,74,,1,,75,
S08000024,202007,234,,28,,262,
S08000025,202007,9,,1,,10,
S08000026,202007,4,,1,,5,
S08000028,202007,6,,1,,7,
S08000029,202007,133,,34,,167,
S08000030,202007,156,,14,,170,
S08000031,202007,401,,145,,546,
S08000032,202007,132,,11,,143,
S92000003,202007,1377,d y,249,d y,1626,d y
S08000015,202006,48,,9,,57,
S08000016,202006,29,,2,,31,
S08000017,202006,52,,4,,56,
S08000019,202006,63,,0,,63,
S08000020,202006,,:,,:,,:
S08000022,202006,67,,2,,69,
S08000024,202006,316,,30,,346,
S08000025,202006,5,,2,,7,
S08000026,202006,9,,6,,15,
S08000028,202006,6,,0,,6,
S08000029,202006,130,,17,,147,
S08000030,202006,188,,39,,227,
S08000031,202006,336,,100,,436,
S08000032,202006,183,,17,,200,
S92000003,202006,1432,d y,228,d y,1660,d y
S08000015,202005,97,,22,,119,
S08000016,202005,17,,0,,17,
S08000017,202005,70,,4,,74,
S08000019,202005,12,,0,,12,
S08000020,202005,,:,,:,,:
S08000022,202005,40,,1,,41,
S08000024,202005,260,,28,,288,
S08000025,202005,4,,0,,4,
S08000026,202005,5,,0,,5,
S08000028,202005,1,,2,,3,
S08000029,202005,220,,38,,258,
S08000030,202005,108,,21,,129,
S08000031,202005,297,,80,,377,
S08000032,202005,159,,18,,177,
S92000003,202005,1290,d y,214,d y,1504,d y
S08000015,202004,119,,24,,143,
S08000016,202004,6,,0,,6,
S08000017,202004,105,,6,,111,
S08000019,202004,103,,20,,123,
S08000020,202004,281,u,39,u,320,u
S08000022,202004,48,,1,,49,
S08000024,202004,352,,27,,379,
S08000025,202004,2,,2,,4,
S08000026,202004,7,,1,,8,
S08000028,202004,7,,0,,7,
S08000029,202004,252,,77,,329,
S08000030,202004,81,,13,,94,
S08000031,202004,149,,14,,163,
S08000032,202004,57,,8,,65,
S92000003,202004,1569,d y,232,d y,1801,d y
S08000015,202003,79,,14,,93,
S08000016,202003,22,,3,,25,
S08000017,202003,86,,6,,92,
S08000019,202003,103,,20,,123,
S08000020,202003,,:,,:,,:
S08000022,202003,50,,7,,57,
S08000024,202003,299,,25,,324,
S08000025,202003,10,,1,,11,
S08000026,202003,1,,0,,1,
S08000028,202003,15,,2,,17,
S08000029,202003,240,,57,,297,
S08000030,202003,88,,16,,104,
S08000031,202003,379,,91,,470,
S08000032,202003,117,,15,,132,
S92000003,202003,1489,d y,257,d y,1746,d y
S08000015,202002,87,,9,,96,
S08000016,202002,28,,4,,32,
S08000017,202002,63,,3,,66,
S08000019,202002,103,,20,,123,
S08000020,202002,,:,,:,,:
S08000022,202002,78,,15,,93,
S08000024,202002,308,,39,,347,
S08000025,202002,13,,1,,14,
S08000026,202002,5,,1,,6,
S08000028,202002,9,,2,,11,
S08000029,202002,187,,17,,204,
S08000030,202002,71,,6,,77,
S08000031,202002,377,,52,,429,
S08000032,202002,132,,25,,157,
S92000003,202002,1461,d y,194,d y,1655,d y
S08000015,202001,96,,15,,111,
S08000016,202001,34,,5,,39,
S08000017,202001,70,,9,,79,
S08000019,202001,103,,20,,123,
S08000020,202001,,:,,:,,:
S08000022,202001,98,,18,,116,
S08000024,202001,325,,29,,354,
S08000025,202001,6,,0,,6,
S08000026,202001,3,,3,,6,
S08000028,202001,11,,1,,12,
S08000029,202001,193,,35,,228,
S08000030,202001,99,,16,,115,
S08000031,202001,356,,80,,436,
S08000032,202001,140,,12,,152,
S92000003,202001,1534,d y,243,d y,1777,d y
S08000015,201912,84,,18,,102,
S08000016,201912,32,,2,,34,
S08000017,201912,82,,4,,86,
S08000019,201912,103,,20,,123,
S08000020,201912,,:,,:,,:
S08000022,201912,74,,1,,75,
S08000024,201912,253,,28,,281,
S08000025,201912,3,,0,,3,
S08000026,201912,3,,0,,3,
S08000028,201912,11,,3,,14,
S08000029,201912,178,,16,,194,
S08000030,201912,75,,22,,97,
S08000031,201912,332,,48,,380,
S08000032,201912,119,,16,,135,
S92000003,201912,1349,d y,178,d y,1527,d y
S08000015,201911,124,,16,,140,
S08000016,201911,42,,2,,44,
S08000017,201911,96,,11,,107,
S08000019,201911,104,b,20,b,124,b
S08000020,201911,,:,,:,,:
S08000022,201911,125,,16,,141,
S08000024,201911,330,,40,,370,
S08000025,201911,4,,0,,4,
S08000026,201911,3,,1,,4,
S08000028,201911,8,,4,,12,
S08000029,201911,231,,30,,261,
S08000030,201911,121,,4,,125,
S08000031,201911,351,,58,,409,
S08000032,201911,182,,22,,204,
S92000003,201911,1721,d y,224,d y,1945,d y
S08000015,201910,98,,19,,117,
S08000016,201910,33,,1,,34,
S08000017,201910,75,,4,,79,
S08000019,201910,101,,20,,121,
S08000020,201910,,:,,:,,:
S08000022,201910,82,,12,,94,
S08000024,201910,336,,48,,384,
S08000025,201910,7,,2,,9,
S08000026,201910,12,,2,,14,
S08000028,201910,10,,1,,11,
S08000029,201910,189,,29,,218,
S08000030,201910,100,,5,,105,
S08000031,201910,353,,56,,409,
S08000032,201910,220,,18,,238,
S92000003,201910,1616,d y,217,d y,1833,d y
S08000015,201909,134,u,15,u,149,u
S08000016,201909,37,u,3,u,40,u
S08000017,201909,74,u,2,u,76,u
S08000019,201909,103,u,17,u,120,u
S08000020,201909,,:,,:,,:
S08000022,201909,63,u,8,u,71,u
S08000024,201909,305,u,30,u,335,u
S08000025,201909,6,u,0,u,6,u
S08000026,201909,15,u,0,u,15,u
S08000028,201909,12,u,3,u,15,u
S08000029,201909,130,u,30,u,160,u
S08000030,201909,128,u,16,u,144,u
S08000031,201909,378,u,46,u,424,u
S08000032,201909,179,u,21,u,200,u
S92000003,201909,1564,d y u,191,d y u,1755,d y u
S08000015,201908,98,u,25,u,123,u
S08000016,201908,31,u,3,u,34,u
S08000017,201908,67,u,5,u,72,u
S08000019,201908,105,u,18,u,123,u
S08000020,201908,,:,,:,,:
S08000022,201908,83,u,8,u,91,u
S08000024,201908,271,u,28,u,299,u
S08000025,201908,2,u,0,u,2,u
S08000026,201908,8,u,0,u,8,u
S08000028,201908,7,u,3,u,10,u
S08000029,201908,149,u,41,u,190,u
S08000030,201908,100,u,9,u,109,u
S08000031,201908,444,u,90,u,534,u
S08000032,201908,195,u,32,u,227,u
S92000003,201908,1560,d y u,262,d y u,1822,d y u
S08000015,201907,128,u,21,u,149,u
S08000016,201907,42,u,2,u,44,u
S08000017,201907,68,u,7,u,75,u
S08000019,201907,93,u,42,u,135,u
S08000020,201907,,:,,:,,:
S08000022,201907,96,u,26,u,122,u
S08000024,201907,276,u,36,u,312,u
S08000025,201907,10,u,1,u,11,u
S08000026,201907,11,u,2,u,13,u
S08000028,201907,7,u,3,u,10,u
S08000029,201907,129,u,34,u,163,u
S08000030,201907,107,u,27,u,134,u
S08000031,201907,455,u,83,u,538,u
S08000032,201907,201,u,37,u,238,u
S92000003,201907,1623,d y u,321,d y u,1944,d y u
S08000015,201906,88,u,12,u,100,u
S08000016,201906,55,u,2,u,57,u
S08000017,201906,72,u,7,u,79,u
S08000019,201906,84,u,27,u,111,u
S08000020,201906,,:,,:,,:
S08000022,201906,103,u,6,u,109,u
S08000024,201906,261,u,55,u,316,u
S08000025,201906,2,u,0,u,2,u
S08000026,201906,11,u,0,u,11,u
S08000028,201906,14,u,0,u,14,u
S08000029,201906,113,u,16,u,129,u
S08000030,201906,98,u,13,u,111,u
S08000031,201906,455,u,77,u,532,u
S08000032,201906,190,u,24,u,214,u
S92000003,201906,1546,d y u,239,d y u,1785,d y u
S08000015,201905,133,u,17,u,150,u
S08000016,201905,59,u,5,u,64,u
S08000017,201905,97,u,5,u,102,u
S08000019,201905,119,u,31,u,150,u
S08000020,201905,,:,,:,,:
S08000022,201905,90,u,6,u,96,u
S08000024,201905,354,u,25,u,379,u
S08000025,201905,5,u,0,u,5,u
S08000026,201905,8,u,0,u,8,u
S08000028,201905,9,u,1,u,10,u
S08000029,201905,195,u,46,u,241,u
S08000030,201905,79,u,7,u,86,u
S08000031,201905,447,u,74,u,521,u
S08000032,201905,182,u,28,u,210,u
S92000003,201905,1777,d y u,245,d y u,2022,d y u
S08000015,201904,120,u,15,u,135,u
S08000016,201904,74,u,0,u,74,u
S08000017,201904,99,u,9,u,108,u
S08000019,201904,140,u,28,u,168,u
S08000020,201904,,:,,:,,:
S08000022,201904,75,u,19,u,94,u
S08000024,201904,293,u,32,u,325,u
S08000025,201904,8,u,1,u,9,u
S08000026,201904,6,u,1,u,7,u
S08000028,201904,9,u,2,u,11,u
S08000029,201904,155,u,19,u,174,u
S08000030,201904,67,u b,6,u b,73,u b
S08000031,201904,395,u,52,u,447,u
S08000032,201904,217,u,22,u,239,u
S92000003,201904,1658,d y u,206,d y u,1864,d y u
S08000015,201903,122,u,10,u,132,u
S08000016,201903,55,u,2,u,57,u
S08000017,201903,85,u,8,u,93,u
S08000019,201903,109,u,21,u,130,u
S08000020,201903,,:,,:,,:
S08000021,201903,417,u,41,u,458,u
S08000022,201903,77,u,4,u,81,u
S08000023,201903,192,u,11,u,203,u
S08000024,201903,306,u,34,u,340,u
S08000025,201903,9,u,2,u,11,u
S08000026,201903,10,u,0,u,10,u
S08000028,201903,13,u,0,u,13,u
S08000029,201903,138,u,22,u,160,u
S08000030,201903,95,u,11,u,106,u
S92000003,201903,1628,d y u,166,d y u,1794,d y u
S08000015,201902,119,u,17,u,136,u
S08000016,201902,42,u,5,u,47,u
S08000017,201902,70,u,3,u,73,u
S08000019,201902,112,u,23,u,135,u
S08000020,201902,,:,,:,,:
S08000021,201902,431,u,56,u,487,u
S08000022,201902,66,u,4,u,70,u
S08000023,201902,154,u,16,u,170,u
S08000024,201902,341,u,35,u,376,u
S08000025,201902,6,u,1,u,7,u
S08000026,201902,4,u,0,u,4,u
S08000028,201902,7,u,2,u,9,u
S08000029,201902,124,u,14,u,138,u
S08000030,201902,78,u,10,u,88,u
S92000003,201902,1554,d y u,186,d y u,1740,d y u
S08000015,201901,154,u,12,u,166,u
S08000016,201901,30,u,1,u,31,u
S08000017,201901,92,u,3,u,95,u
S08000019,201901,85,u,20,u,105,u
S08000020,201901,,:,,:,,:
S08000021,201901,530,u,69,u,599,u
S08000022,201901,71,u,3,u,74,u
S08000023,201901,184,u,12,u,196,u
S08000024,201901,285,u,31,u,316,u
S08000025,201901,7,u,2,u,9,u
S08000026,201901,5,u,1,u,6,u
S08000028,201901,8,u,3,u,11,u
S08000029,201901,164,u,18,u,182,u
S08000030,201901,99,u,5,u,104,u
S92000003,201901,1714,d y u,180,d y u,1894,d y u
S08000015,201812,99,u,11,u,110,u
S08000016,201812,34,u,6,u,40,u
S08000017,201812,73,u,3,u,76,u
S08000019,201812,92,u,11,u,103,u
S08000020,201812,,:,,:,,:
S08000021,201812,446,u,42,u,488,u
S08000022,201812,67,u,2,u,69,u
S08000023,201812,141,u,23,u,164,u
S08000024,201812,206,u,28,u,234,u
S08000025,201812,5,u,0,u,5,u
S08000026,201812,9,u,0,u,9,u
S08000028,201812,5,u,0,u,5,u
S08000029,201812,95,u,7,u,102,u
S08000030,201812,58,u,5,u,63,u
S92000003,201812,1330,d y u,138,d y u,1468,d y u
S08000015,201811,121,u,15,u,136,u
S08000016,201811,26,u,2,u,28,u
S08000017,201811,97,u,4,u,101,u
S08000019,201811,124,u,16,u,140,u
S08000020,201811,,:,,:,,:
S08000021,201811,689,u,69,u,758,u
S08000022,201811,117,u,14,u,131,u
S08000023,201811,192,u,23,u,215,u
S08000024,201811,288,u,29,u,317,u
S08000025,201811,8,u,2,u,10,u
S08000026,201811,9,u,1,u,10,u
S08000028,201811,8,u,1,u,9,u
S08000029,201811,156,u,21,u,177,u
S08000030,201811,83,u,14,u,97,u
S92000003,201811,1918,d y u,211,d y u,2129,d y u
S08000015,201810,117,u,26,u,143,u
S08000016,201810,43,u,4,u,47,u
S08000017,201810,78,u,3,u,81,u
S08000019,201810,140,u,11,u,151,u
S08000020,201810,,:,,:,,:
S08000021,201810,553,u,62,u,615,u
S08000022,201810,73,u,5,u,78,u
S08000023,201810,200,u,19,u,219,u
S08000024,201810,287,u,26,u,313,u
S08000025,201810,4,u,1,u,5,u
S08000026,201810,6,u,0,u,6,u
S08000028,201810,14,u,3,u,17,u
S08000029,201810,172,u,26,u,198,u
S08000030,201810,95,u,7,u,102,u
S92000003,201810,1782,d y u,193,d y u,1975,d y u
S08000015,201809,108,u,15,u,123,u
S08000016,201809,29,u,2,u,31,u
S08000017,201809,68,u,2,u,70,u
S08000019,201809,124,u,13,u,137,u
S08000020,201809,,:,,:,,:
S08000021,201809,353,u,41,u,394,u
S08000022,201809,123,u,27,u,150,u
S08000023,201809,201,u,16,u,217,u
S08000024,201809,244,u,28,u,272,u
S08000025,201809,8,u,4,u,12,u
S08000026,201809,7,u,2,u,9,u
S08000028,201809,12,u,1,u,13,u
S08000029,201809,158,u,19,u,177,u
S08000030,201809,108,u,12,u,120,u
S92000003,201809,1543,d y u,182,d y u,1725,d y u
S08000015,201808,111,u,14,u,125,u
S08000016,201808,36,u,4,u,40,u
S08000017,201808,72,u,6,u,78,u
S08000019,201808,182,u,19,u,201,u
S08000020,201808,,:,,:,,:
S08000021,201808,392,u,65,u,457,u
S08000022,201808,85,u,12,u,97,u
S08000023,201808,193,u,23,u,216,u
S08000024,201808,287,u,32,u,319,u
S08000025,201808,6,u,0,u,6,u
S08000026,201808,8,u,1,u,9,u
S08000028,201808,3,u,1,u,4,u
S08000029,201808,156,u,43,u,199,u
S08000030,201808,121,u,14,u,135,u
S92000003,201808,1652,d y u,234,d y u,1886,d y u
S08000015,201807,119,u,17,u,136,u
S08000016,201807,35,u,4,u,39,u
S08000017,201807,68,u,8,u,76,u
S08000019,201807,118,u,19,u,137,u
S08000020,201807,,:,,:,,:
S08000021,201807,326,u,73,u,399,u
S08000022,201807,42,u,1,u,43,u
S08000023,201807,162,u,33,u,195,u
S08000024,201807,207,u,36,u,243,u
S08000025,201807,11,u,0,u,11,u
S08000026,201807,11,u,2,u,13,u
S08000028,201807,8,u,2,u,10,u
S08000029,201807,158,u,37,u,195,u
S08000030,201807,84,u,10,u,94,u
S92000003,201807,1349,d y u,242,d y u,1591,d y u
S08000015,201806,135,u,12,u,147,u
S08000016,201806,30,u,1,u,31,u
S08000017,201806,87,u,5,u,92,u
S08000019,201806,131,u,14,u,145,u
S08000020,201806,,:,,:,,:
S08000021,201806,429,u,70,u,499,u
S08000022,201806,116,u,4,u,120,u
S08000023,201806,171,u,30,u,201,u
S08000024,201806,278,u,28,u,306,u
S08000025,201806,11,u,0,u,11,u
S08000026,201806,7,u,0,u,7,u
S08000028,201806,12,u,0,u,12,u
S08000029,201806,169,u,30,u,199,u
S08000030,201806,121,u,19,u,140,u
S92000003,201806,1697,d y u,213,d y u,1910,d y u
S08000015,201805,141,u,18,u,159,u
S08000016,201805,39,u,3,u,42,u
S08000017,201805,80,u,0,u,80,u
S08000019,201805,147,u,22,u,169,u
S08000020,201805,,:,,:,,:
S08000021,201805,449,u,70,u,519,u
S08000022,201805,116,u,8,u,124,u
S08000023,201805,203,u,19,u,222,u
S08000024,201805,326,u,40,u,366,u
S08000025,201805,7,u,1,u,8,u
S08000026,201805,12,u,3,u,15,u
S08000028,201805,9,u,2,u,11,u
S08000029,201805,160,u,29,u,189,u
S08000030,201805,126,u,10,u,136,u
S92000003,201805,1815,d y u,225,d y u,2040,d y u
S08000015,201804,111,u,19,u,130,u
S08000016,201804,33,u,3,u,36,u
S08000017,201804,75,u,5,u,80,u
S08000019,201804,120,u,15,u,135,u
S08000020,201804,,:,,:,,:
S08000021,201804,325,u,61,u,386,u
S08000022,201804,59,u,10,u,69,u
S08000023,201804,199,u,23,u,222,u
S08000024,201804,254,u,42,u,296,u
S08000025,201804,7,u,0,u,7,u
S08000026,201804,5,u,2,u,7,u
S08000028,201804,5,u,1,u,6,u
S08000029,201804,124,u,27,u,151,u
S08000030,201804,134,u,10,u,144,u
S92000003,201804,1451,d y u,218,d y u,1669,d y u
S08000015,201803,137,u,11,u,148,u
S08000016,201803,21,u,7,u,28,u
S08000017,201803,88,u,6,u,94,u
S08000019,201803,120,u,11,u,131,u
S08000020,201803,,:,,:,,:
S08000021,201803,356,u,50,u,406,u
S08000022,201803,42,u,2,u,44,u
S08000023,201803,172,u,17,u,189,u
S08000024,201803,260,u,44,u,304,u
S08000025,201803,14,u,4,u,18,u
S08000026,201803,12,u,1,u,13,u
S08000028,201803,7,u,2,u,9,u
S08000029,201803,131,u,29,u,160,u
S08000030,201803,129,u,18,u,147,u
S92000003,201803,1489,d y u,202,d y u,1691,d y u
S08000015,201802,135,u,6,u,141,u
S08000016,201802,35,u,1,u,36,u
S08000017,201802,70,u,8,u,78,u
S08000019,201802,114,u,18,u,132,u
S08000020,201802,,:,,:,,:
S08000021,201802,334,u,47,u,381,u
S08000022,201802,75,u,6,u,81,u
S08000023,201802,157,u,9,u,166,u
S08000024,201802,256,u,44,u,300,u
S08000025,201802,7,u,2,u,9,u
S08000026,201802,8,u,0,u,8,u
S08000028,201802,5,u,2,u,7,u
S08000029,201802,144,u,29,u,173,u
S08000030,201802,94,u,1,u,95,u
S92000003,201802,1434,d y u,173,d y u,1607,d y u
S08000015,201801,127,u,14,u,141,u
S08000016,201801,26,u,2,u,28,u
S08000017,201801,62,u,5,u,67,u
S08000018,201801,177,u,30,u,207,u
S08000019,201801,82,u,17,u,99,u
S08000020,201801,,:,,:,,:
S08000021,201801,331,u,54,u,385,u
S08000022,201801,41,u,2,u,43,u
S08000023,201801,169,u,15,u,184,u
S08000024,201801,266,u,41,u,307,u
S08000025,201801,13,u,3,u,16,u
S08000026,201801,6,u,0,u,6,u
S08000027,201801,89,u,4,u,93,u
S08000028,201801,10,u,2,u,12,u
S92000003,201801,1399,d y u,189,d y u,1588,d y u
S08000015,201712,110,u,5,u,115,u
S08000016,201712,17,u,2,u,19,u
S08000017,201712,70,u,5,u,75,u
S08000018,201712,104,u,27,u,131,u
S08000019,201712,87,u,9,u,96,u
S08000020,201712,,:,,:,,:
S08000021,201712,305,u,38,u,343,u
S08000022,201712,65,u,0,u,65,u
S08000023,201712,167,u,23,u,190,u
S08000024,201712,195,u,29,u,224,u
S08000025,201712,6,u,0,u,6,u
S08000026,201712,3,u,0,u,3,u
S08000027,201712,90,u,44,u,134,u
S08000028,201712,5,u,0,u,5,u
S92000003,201712,1224,d y u,182,d y u,1406,d y u
S08000015,201711,153,u,7,u,160,u
S08000016,201711,33,u,6,u,39,u
S08000017,201711,77,u,19,u,96,u
S08000018,201711,172,u,32,u,204,u
S08000019,201711,119,u,15,u,134,u
S08000020,201711,,:,,:,,:
S08000021,201711,429,u,43,u,472,u
S08000022,201711,94,u,0,u,94,u
S08000023,201711,216,u,18,u,234,u
S08000024,201711,309,u,31,u,340,u
S08000025,201711,11,u,4,u,15,u
S08000026,201711,10,u,0,u,10,u
S08000027,201711,129,u,45,u,174,u
S08000028,201711,10,u,3,u,13,u
S92000003,201711,1762,d y u,223,d y u,1985,d y u
S08000015,201710,121,u,19,u,140,u
S08000016,201710,21,u,3,u,24,u
S08000017,201710,64,u,4,u,68,u
S08000018,201710,151,u,32,u,183,u
S08000019,201710,68,u,10,u,78,u
S08000020,201710,,:,,:,,:
S08000021,201710,356,u,26,u,382,u
S08000022,201710,84,u,13,u,97,u
S08000023,201710,207,u,24,u,231,u
S08000024,201710,273,u,38,u,311,u
S08000025,201710,5,u,0,u,5,u
S08000026,201710,8,u,1,u,9,u
S08000027,201710,80,u,21,u,101,u
S08000028,201710,15,u,0,u,15,u
S92000003,201710,1453,d y u,191,d y u,1644,d y u
S08000015,201709,117,u,5,u,122,u
S08000016,201709,18,u,0,u,18,u
S08000017,201709,52,u,6,u,58,u
S08000018,201709,136,u,20,u,156,u
S08000019,201709,80,u,12,u,92,u
S08000020,201709,,:,,:,,:
S08000021,201709,322,u,48,u,370,u
S08000022,201709,99,u,25,u,124,u
S08000023,201709,176,u,22,u,198,u
S08000024,201709,226,u,24,u,250,u
S08000025,201709,4,u,0,u,4,u
S08000026,201709,7,u,1,u,8,u
S08000027,201709,53,u,11,u,64,u
S08000028,201709,11,u,1,u,12,u
S92000003,201709,1301,d y u,175,d y u,1476,d y u
S08000015,201708,138,u,12,u,150,u
S08000016,201708,29,u,5,u,34,u
S08000017,201708,51,u,9,u,60,u
S08000018,201708,152,u,21,u,173,u
S08000019,201708,106,u,8,u,114,u
S08000020,201708,,:,,:,,:
S08000021,201708,352,u,77,u,429,u
S08000022,201708,78,u,13,u,91,u
S08000023,201708,209,u,29,u,238,u
S08000024,201708,250,u,53,u,303,u
S08000025,201708,3,u,0,u,3,u
S08000026,201708,8,u,0,u,8,u
S08000027,201708,62,u,19,u,81,u
S08000028,201708,8,u,2,u,10,u
S92000003,201708,1446,d y u,248,d y u,1694,d y u
S08000015,201707,100,u,0,u,100,u
S08000016,201707,26,u,0,u,26,u
S08000017,201707,54,u,8,u,62,u
S08000018,201707,118,u,29,u,147,u
S08000019,201707,94,u,11,u,105,u
S08000020,201707,,:,,:,,:
S08000021,201707,297,u,56,u,353,u
S08000022,201707,69,u,6,u,75,u
S08000023,201707,184,u,36,u,220,u
S08000024,201707,171,u,41,u,212,u
S08000025,201707,2,u,1,u,3,u
S08000026,201707,1,u,0,u,1,u
S08000027,201707,65,u,16,u,81,u
S08000028,201707,14,u,0,u,14,u
S92000003,201707,1195,d y u,204,d y u,1399,d y u
S08000015,201706,131,u,13,u,144,u
S08000016,201706,36,u,6,u,42,u
S08000017,201706,72,u,13,u,85,u
S08000018,201706,163,u,27,u,190,u
S08000019,201706,108,u,9,u,117,u
S08000020,201706,,:,,:,,:
S08000021,201706,353,u,59,u,412,u
S08000022,201706,125,u,6,u,131,u
S08000023,201706,189,u,22,u,211,u
S08000024,201706,327,u,27,u,354,u
S08000025,201706,11,u,4,u,15,u
S08000026,201706,12,u,5,u,17,u
S08000027,201706,76,u,27,u,103,u
S08000028,201706,17,u,3,u,20,u
S92000003,201706,1620,d y u,221,d y u,1841,d y u
S08000015,201705,137,u,13,u,150,u
S08000016,201705,28,u,2,u,30,u
S08000017,201705,63,u,8,u,71,u
S08000018,201705,172,u,26,u,198,u
S08000019,201705,100,u,14,u,114,u
S08000020,201705,,:,,:,,:
S08000021,201705,384,u,65,u,449,u
S08000022,201705,126,u,9,u,135,u
S08000023,201705,189,u,25,u,214,u
S08000024,201705,326,u,37,u,363,u
S08000025,201705,2,u,0,u,2,u
S08000026,201705,8,u,0,u,8,u
S08000027,201705,126,u,29,u,155,u
S08000028,201705,5,u,2,u,7,u
S92000003,201705,1666,d y u,230,d y u,1896,d y u
S08000015,201704,112,u,16,u,128,u
S08000016,201704,31,u,11,u,42,u
S08000017,201704,63,u,7,u,70,u
S08000018,201704,133,u,17,u,150,u
S08000019,201704,85,u,11,u,96,u
S08000020,201704,,:,,:,,:
S08000021,201704,272,u,48,u,320,u
S08000022,201704,106,u,25,u,131,u
S08000023,201704,164,u,22,u,186,u
S08000024,201704,228,u,29,u,257,u
S08000025,201704,2,u,0,u,2,u
S08000026,201704,0,u,0,u,0,u
S08000027,201704,144,u,6,u,150,u
S08000028,201704,12,u,3,u,15,u
S92000003,201704,1352,d y u,195,d y u,1547,d y u
S08000015,201703,140,u,9,u,149,u
S08000016,201703,38,u,7,u,45,u
S08000017,201703,72,u,7,u,79,u
S08000018,201703,137,u,13,u,150,u
S08000019,201703,104,u,12,u,116,u
S08000020,201703,,:,,:,,:
S08000021,201703,386,u,53,u,439,u
S08000022,201703,258,u,47,u,305,u
S08000023,201703,167,u,23,u,190,u
S08000024,201703,311,u,34,u,345,u
S08000025,201703,5,u,0,u,5,u
S08000026,201703,6,u,0,u,6,u
S08000027,201703,141,u,22,u,163,u
S08000028,201703,12,u,1,u,13,u
S92000003,201703,1777,d y u,228,d y u,2005,d y u
S08000015,201702,98,u,15,u,113,u
S08000016,201702,50,u,7,u,57,u
S08000017,201702,63,u,5,u,68,u
S08000018,201702,125,u,23,u,148,u
S08000019,201702,88,u,14,u,102,u
S08000020,201702,,:,,:,,:
S08000021,201702,391,u,51,u,442,u
S08000022,201702,270,u,46,u,316,u
S08000023,201702,153,u,11,u,164,u
S08000024,201702,274,u,34,u,308,u
S08000025,201702,12,u,0,u,12,u
S08000026,201702,10,u,0,u,10,u
S08000027,201702,120,u,13,u,133,u
S08000028,201702,14,u,0,u,14,u
S92000003,201702,1668,d y u,219,d y u,1887,d y u
S08000015,201701,104,u,22,u,126,u
S08000016,201701,31,u,3,u,34,u
S08000017,201701,61,u,7,u,68,u
S08000018,201701,131,u,12,u,143,u
S08000019,201701,97,u,5,u,102,u
S08000020,201701,,:,,:,,:
S08000021,201701,326,u,52,u,378,u
S08000022,201701,258,u,69,u,327,u
S08000023,201701,149,u,15,u,164,u
S08000024,201701,249,u,22,u,271,u
S08000025,201701,6,u,0,u,6,u
S08000026,201701,7,u,0,u,7,u
S08000027,201701,118,u,15,u,133,u
S08000028,201701,5,u,1,u,6,u
S92000003,201701,1542,d y u,223,d y u,1765,d y u
S08000015,201612,107,u,19,u,126,u
S08000016,201612,37,u,7,u,44,u
S08000017,201612,40,u,5,u,45,u
S08000018,201612,126,u,32,u,158,u
S08000019,201612,95,u,15,u,110,u
S08000020,201612,,:,,:,,:
S08000021,201612,313,u,58,u,371,u
S08000022,201612,112,u,14,u,126,u
S08000023,201612,131,u,15,u,146,u
S08000024,201612,181,u,17,u,198,u
S08000025,201612,14,u,0,u,14,u
S08000026,201612,3,u,0,u,3,u
S08000027,201612,94,u,8,u,102,u
S08000028,201612,9,u,0,u,9,u
S92000003,201612,1262,d y u,190,d y u,1452,d y u
S08000015,201611,139,u,15,u,154,u
S08000016,201611,60,u,11,u,71,u
S08000017,201611,49,u,6,u,55,u
S08000018,201611,158,u,23,u,181,u
S08000019,201611,107,u,11,u,118,u
S08000020,201611,,:,,:,,:
S08000021,201611,371,u,59,u,430,u
S08000022,201611,154,u,12,u,166,u
S08000023,201611,210,u,19,u,229,u
S08000024,201611,309,u,16,u,325,u
S08000025,201611,12,u,1,u,13,u
S08000026,201611,10,u,0,u,10,u
S08000027,201611,146,u,23,u,169,u
S08000028,201611,8,u,0,u,8,u
S92000003,201611,1733,d y u,196,d y u,1929,d y u
S08000015,201610,135,u,21,u,156,u
S08000016,201610,55,u,7,u,62,u
S08000017,201610,54,u,9,u,63,u
S08000018,201610,124,u,28,u,152,u
S08000019,201610,96,u,17,u,113,u
S08000020,201610,,:,,:,,:
S08000021,201610,319,u,52,u,371,u
S08000022,201610,118,u,11,u,129,u
S08000023,201610,195,u,26,u,221,u
S08000024,201610,253,u,30,u,283,u
S08000025,201610,2,u,0,u,2,u
S08000026,201610,2,u,0,u,2,u
S08000027,201610,135,u,19,u,154,u
S08000028,201610,12,u,2,u,14,u
S92000003,201610,1500,d y u,222,d y u,1722,d y u
S08000015,201609,107,u,10,u,117,u
S08000016,201609,78,u,11,u,89,u
S08000017,201609,54,u,8,u,62,u
S08000018,201609,157,u,18,u,175,u
S08000019,201609,128,u,14,u,142,u
S08000020,201609,,:,,:,,:
S08000021,201609,337,u,43,u,380,u
S08000022,201609,102,u,1,u,103,u
S08000023,201609,186,u,20,u,206,u
S08000024,201609,286,u,23,u,309,u
S08000025,201609,2,u,1,u,3,u
S08000026,201609,11,u,0,u,11,u
S08000027,201609,98,u,11,u,109,u
S08000028,201609,14,u,0,u,14,u
S92000003,201609,1560,d y u,160,d y u,1720,d y u
S08000015,201608,110,u,14,u,124,u
S08000016,201608,79,u,7,u,86,u
S08000017,201608,53,u,10,u,63,u
S08000018,201608,126,u,23,u,149,u
S08000019,201608,121,u,11,u,132,u
S08000020,201608,,:,,:,,:
S08000021,201608,348,u,71,u,419,u
S08000022,201608,122,u,18,u,140,u
S08000023,201608,168,u,29,u,197,u
S08000024,201608,274,u,45,u,319,u
S08000025,201608,1,u,1,u,2,u
S08000026,201608,5,u,0,u,5,u
S08000027,201608,136,u,31,u,167,u
S08000028,201608,8,u,0,u,8,u
S92000003,201608,1551,d y u,260,d y u,1811,d y u
S08000015,201607,87,u,13,u,100,u
S08000016,201607,63,u,9,u,72,u
S08000017,201607,47,u,8,u,55,u
S08000018,201607,154,u,22,u,176,u
S08000019,201607,94,u,33,u,127,u
S08000020,201607,,:,,:,,:
S08000021,201607,298,u,70,u,368,u
S08000022,201607,73,u,19,u,92,u
S08000023,201607,149,u,24,u,173,u
S08000024,201607,223,u,41,u,264,u
S08000025,201607,6,u,1,u,7,u
S08000026,201607,7,u,1,u,8,u
S08000027,201607,107,u,18,u,125,u
S08000028,201607,15,u,0,u,15,u
S92000003,201607,1323,d y u,259,d y u,1582,d y u
S08000015,201606,140,u,13,u,153,u
S08000016,201606,65,u,5,u,70,u
S08000017,201606,77,u,8,u,85,u
S08000018,201606,141,u,25,u,166,u
S08000019,201606,113,u,35,u,148,u
S08000020,201606,,:,,:,,:
S08000021,201606,344,u,45,u,389,u
S08000022,201606,162,u,6,u,168,u
S08000023,201606,156,u,54,u,210,u
S08000024,201606,306,u,37,u,343,u
S08000025,201606,10,u,5,u,15,u
S08000026,201606,8,u,0,u,8,u
S08000027,201606,111,u,23,u,134,u
S08000028,201606,12,u,0,u,12,u
S92000003,201606,1645,d y u,256,d y u,1901,d y u
S08000015,201605,119,u,11,u,130,u
S08000016,201605,86,u,16,u,102,u
S08000017,201605,67,u,7,u,74,u
S08000018,201605,158,u,29,u,187,u
S08000019,201605,148,u,25,u,173,u
S08000020,201605,,:,,:,,:
S08000021,201605,342,u,78,u,420,u
S08000022,201605,120,u,7,u,127,u
S08000023,201605,177,u,24,u,201,u
S08000024,201605,402,u,44,u,446,u
S08000025,201605,9,u,2,u,11,u
S08000026,201605,8,u,0,u,8,u
S08000027,201605,144,u,29,u,173,u
S08000028,201605,8,u,1,u,9,u
S92000003,201605,1788,d y u,273,d y u,2061,d y u
S08000015,201604,85,u,26,u,111,u
S08000016,201604,84,u,4,u,88,u
S08000017,201604,60,u,5,u,65,u
S08000018,201604,132,u,29,u,161,u
S08000019,201604,79,u,20,u,99,u
S08000020,201604,,:,,:,,:
S08000021,201604,345,u,49,u,394,u
S08000022,201604,121,u,9,u,130,u
S08000023,201604,164,u,21,u,185,u
S08000024,201604,335,u,30,u,365,u
S08000025,201604,5,u,3,u,8,u
S08000026,201604,15,u,5,u,20,u
S08000027,201604,171,u,22,u,193,u
S08000028,201604,10,u,3,u,13,u
S92000003,201604,1606,d y u,226,d y u,1832,d y u
S08000015,201603,122,u,11,u,133,u
S08000016,201603,83,u,11,u,94,u
S08000017,201603,54,u,8,u,62,u
S08000018,201603,145,u,22,u,167,u
S08000019,201603,86,u,15,u,101,u
S08000020,201603,154,u,9,u,163,u
S08000021,201603,362,u,65,u,427,u
S08000022,201603,74,u,7,u,81,u
S08000023,201603,186,u,20,u,206,u
S08000024,201603,433,u,44,u,477,u
S08000025,201603,8,u,5,u,13,u
S08000026,201603,1,u,0,u,1,u
S08000027,201603,126,u,16,u,142,u
S08000028,201603,12,u,2,u,14,u
S92000003,201603,1846,d u,235,d u,2081,d u
S08000015,201602,120,u,10,u,130,u
S08000016,201602,68,u,4,u,72,u
S08000017,201602,58,u,8,u,66,u
S08000018,201602,147,u,28,u,175,u
S08000019,201602,99,u,21,u,120,u
S08000020,201602,163,u,8,u,171,u
S08000021,201602,360,u,59,u,419,u
S08000022,201602,47,u,3,u,50,u
S08000023,201602,186,u,35,u,221,u
S08000024,201602,408,u,34,u,442,u
S08000025,201602,6,u,0,u,6,u
S08000026,201602,11,u,1,u,12,u
S08000027,201602,160,u,27,u,187,u
S08000028,201602,19,u,3,u,22,u
S92000003,201602,1852,d u,241,d u,2093,d u
S08000015,201601,102,u,14,u,116,u
S08000016,201601,102,u,16,u,118,u
S08000017,201601,56,u,9,u,65,u
S08000018,201601,148,u,34,u,182,u
S08000019,201601,75,u,20,u,95,u
S08000020,201601,150,u,8,u,158,u
S08000021,201601,346,u,63,u,409,u
S08000022,201601,53,u,4,u,57,u
S08000023,201601,175,u,30,u,205,u
S08000024,201601,372,u,34,u,406,u
S08000025,201601,13,u,3,u,16,u
S08000026,201601,3,u,0,u,3,u
S08000027,201601,147,u,32,u,179,u
S08000028,201601,8,u,4,u,12,u
S92000003,201601,1750,d u,271,d u,2021,d u
S08000015,201512,107,u,10,u,117,u
S08000016,201512,74,u,10,u,84,u
S08000017,201512,44,u,6,u,50,u
S08000018,201512,127,u,23,u,150,u
S08000019,201512,117,u,37,u,154,u
S08000020,201512,129,u,1,u,130,u
S08000021,201512,317,u,68,u,385,u
S08000022,201512,65,u,6,u,71,u
S08000023,201512,145,u,24,u,169,u
S08000024,201512,345,u,45,u,390,u
S08000025,201512,8,u,0,u,8,u
S08000026,201512,6,u,1,u,7,u
S08000027,201512,90,u,23,u,113,u
S08000028,201512,6,u,0,u,6,u
S92000003,201512,1580,d u,254,d u,1834,d u
S08000015,201511,112,u,9,u,121,u
S08000016,201511,55,u,7,u,62,u
S08000017,201511,60,u,13,u,73,u
S08000018,201511,181,u,22,u,203,u
S08000019,201511,151,u,21,u,172,u
S08000020,201511,165,u,3,u,168,u
S08000021,201511,396,u,65,u,461,u
S08000022,201511,82,u,10,u,92,u
S08000023,201511,204,u,26,u,230,u
S08000024,201511,412,u,43,u,455,u
S08000025,201511,3,u,1,u,4,u
S08000026,201511,6,u,2,u,8,u
S08000027,201511,180,u,36,u,216,u
S08000028,201511,8,u,0,u,8,u
S92000003,201511,2015,d u,258,d u,2273,d u
S08000015,201510,122,u,5,u,127,u
S08000016,201510,31,u,4,u,35,u
S08000017,201510,48,u,11,u,59,u
S08000018,201510,145,u,27,u,172,u
S08000019,201510,62,u,12,u,74,u
S08000020,201510,90,u,6,u,96,u
S08000021,201510,342,u,56,u,398,u
S08000022,201510,44,u,3,u,47,u
S08000023,201510,181,u,45,u,226,u
S08000024,201510,356,u,49,u,405,u
S08000025,201510,10,u,1,u,11,u
S08000026,201510,4,u,2,u,6,u
S08000027,201510,238,u,59,u,297,u
S08000028,201510,10,u,0,u,10,u
S92000003,201510,1683,d u,280,d u,1963,d u
S08000015,201509,89,u,8,u,97,u
S08000016,201509,29,u,4,u,33,u
S08000017,201509,60,u,1,u,61,u
S08000018,201509,206,u,24,u,230,u
S08000019,201509,122,u,13,u,135,u
S08000020,201509,127,u,12,u,139,u
S08000021,201509,332,u,69,u,401,u
S08000022,201509,65,u,7,u,72,u
S08000023,201509,185,u,34,u,219,u
S08000024,201509,452,u,47,u,499,u
S08000025,201509,6,u,2,u,8,u
S08000026,201509,3,u,0,u,3,u
S08000027,201509,122,u,28,u,150,u
S08000028,201509,7,u,0,u,7,u
S92000003,201509,1805,d u,249,d u,2054,d u
S08000015,201508,81,u,13,u,94,u
S08000016,201508,58,u,12,u,70,u
S08000017,201508,37,u,11,u,48,u
S08000018,201508,142,u,24,u,166,u
S08000019,201508,59,u,15,u,74,u
S08000020,201508,175,u,18,u,193,u
S08000021,201508,268,u,69,u,337,u
S08000022,201508,58,u,6,u,64,u
S08000023,201508,164,u,39,u,203,u
S08000024,201508,359,u,42,u,401,u
S08000025,201508,3,u,2,u,5,u
S08000026,201508,3,u,0,u,3,u
S08000027,201508,174,u,27,u,201,u
S08000028,201508,6,u,0,u,6,u
S92000003,201508,1587,d u,278,d u,1865,d u
S08000015,201507,103,u,10,u,113,u
S08000016,201507,55,u,5,u,60,u
S08000017,201507,48,u,8,u,56,u
S08000018,201507,187,u,21,u,208,u
S08000019,201507,43,u,15,u,58,u
S08000020,201507,165,u,22,u,187,u
S08000021,201507,286,u,83,u,369,u
S08000022,201507,69,u,7,u,76,u
S08000023,201507,142,u,51,u,193,u
S08000024,201507,350,u,67,u,417,u
S08000025,201507,3,u,1,u,4,u
S08000026,201507,7,u,2,u,9,u
S08000027,201507,18,u,5,u,23,u
S08000028,201507,7,u,4,u,11,u
S92000003,201507,1483,d u,301,d u,1784,d u
S08000015,201506,100,u,12,u,112,u
S08000016,201506,81,u,8,u,89,u
S08000017,201506,60,u,11,u,71,u
S08000018,201506,242,u,19,u,261,u
S08000019,201506,59,u,8,u,67,u
S08000020,201506,192,u,18,u,210,u
S08000021,201506,391,u,89,u,480,u
S08000022,201506,92,u,17,u,109,u
S08000023,201506,141,u,37,u,178,u
S08000024,201506,455,u,58,u,513,u
S08000025,201506,6,u,0,u,6,u
S08000026,201506,,:,,:,,:
S08000027,201506,37,u,8,u,45,u
S08000028,201506,15,u,0,u,15,u
S92000003,201506,1871,d u,285,d u,2156,d u
S08000015,201505,94,u,10,u,104,u
S08000016,201505,61,u,6,u,67,u
S08000017,201505,50,u,6,u,56,u
S08000018,201505,153,u,19,u,172,u
S08000019,201505,63,u,9,u,72,u
S08000020,201505,150,u,9,u,159,u
S08000021,201505,377,u,58,u,435,u
S08000022,201505,89,u,6,u,95,u
S08000023,201505,188,u,27,u,215,u
S08000024,201505,429,u,54,u,483,u
S08000025,201505,8,u,3,u,11,u
S08000026,201505,,:,,:,,:
S08000027,201505,39,u,3,u,42,u
S08000028,201505,8,u,1,u,9,u
S92000003,201505,1709,d u,211,d u,1920,d u
S08000015,201504,107,u,15,u,122,u
S08000016,201504,89,u,15,u,104,u
S08000017,201504,70,u,17,u,87,u
S08000018,201504,180,u,29,u,209,u
S08000019,201504,117,u,14,u,131,u
S08000020,201504,130,u,11,u,141,u
S08000021,201504,377,u,82,u,459,u
S08000022,201504,99,u,10,u,109,u
S08000023,201504,160,u,30,u,190,u
S08000024,201504,396,u,47,u,443,u
S08000025,201504,3,u,0,u,3,u
S08000026,201504,,:,,:,,:
S08000027,201504,54,u,10,u,64,u
S08000028,201504,18,u,1,u,19,u
S92000003,201504,1800,d u,281,d u,2081,d u
S08000015,201503,110,u,10,u,120,u
S08000016,201503,138,u,11,u,149,u
S08000017,201503,67,u,8,u,75,u
S08000018,201503,126,u,23,u,149,u
S08000019,201503,65,u,7,u,72,u
S08000020,201503,147,u,16,u,163,u
S08000021,201503,403,u,74,u,477,u
S08000022,201503,,:,,:,,:
S08000023,201503,187,u,23,u,210,u
S08000024,201503,469,u,46,u,515,u
S08000025,201503,7,u,0,u,7,u
S08000026,201503,,:,,:,,:
S08000027,201503,72,u,9,u,81,u
S08000028,201503,9,u,2,u,11,u
S92000003,201503,1800,d u,229,d u,2029,d u
S08000015,201502,115,u,7,u,122,u
S08000016,201502,110,u,5,u,115,u
S08000017,201502,49,u,2,u,51,u
S08000018,201502,171,u,19,u,190,u
S08000019,201502,37,u,7,u,44,u
S08000020,201502,182,u,13,u,195,u
S08000021,201502,377,u,64,u,441,u
S08000022,201502,,:,,:,,:
S08000023,201502,182,u,30,u,212,u
S08000024,201502,412,u,28,u,440,u
S08000025,201502,7,u,6,u,13,u
S08000026,201502,0,u,0,u,0,u
S08000027,201502,64,u,6,u,70,u
S08000028,201502,7,u,3,u,10,u
S92000003,201502,1713,d u,190,d u,1903,d u
S08000015,201501,101,u,15,u,116,u
S08000016,201501,89,u,10,u,99,u
S08000017,201501,67,u,2,u,69,u
S08000018,201501,198,u,21,u,219,u
S08000019,201501,67,u,7,u,74,u
S08000020,201501,162,u,14,u,176,u
S08000021,201501,398,u,72,u,470,u
S08000022,201501,,:,,:,,:
S08000023,201501,173,u,17,u,190,u
S08000024,201501,469,u,46,u,515,u
S08000025,201501,3,u,3,u,6,u
S08000026,201501,5,u,0,u,5,u
S08000027,201501,78,u,14,u,92,u
S08000028,201501,15,u,1,u,16,u
S92000003,201501,1825,d u,222,d u,2047,d u
